{
    "id": "1",
    "name": "Get ready, player !",
    "defaultWall": 100,
    "defaultGround": 202,
    "width": 33,
    "height": 33,
    "gridstr": [
        100, 100, 100, 100, 100, 100, 100, 100, 100, 100, 100, 100, 100, 100, 100, 100, 100, 100,
        100, 100, 100, 100, 100, 100, 100, 100, 100, 100, 100, 100, 100, 100, 100, 100, 202, 202,
        202, 100, 100, 100, 202, 202, 202, 202, 202, 202, 202, 202, 202, 202, 202, 202, 100, 100,
        100, 202, 202, 202, 202, 202, 202, 202, 202, 202, 202, 100, 100, 202, 902, 202, 100, 100,
        100, 202, 202, 202, 202, 202, 202, 202, 202, 202, 202, 202, 202, 100, 100, 100, 202, 202,
        202, 202, 202, 202, 202, 202, 202, 202, 100, 100, 202, 202, 202, 100, 100, 100, 202, 202,
        202, 202, 202, 202, 202, 202, 202, 202, 202, 202, 100, 100, 100, 202, 202, 202, 202, 202,
        202, 202, 202, 202, 202, 100, 100, 202, 202, 202, 100, 100, 100, 202, 202, 202, 202, 202,
        202, 202, 202, 202, 202, 202, 202, 100, 100, 100, 202, 202, 202, 202, 202, 202, 202, 202,
        202, 202, 100, 100, 202, 202, 202, 100, 100, 100, 202, 202, 202, 202, 202, 202, 202, 202,
        202, 202, 202, 202, 100, 100, 100, 202, 202, 202, 202, 202, 202, 202, 202, 202, 202, 100,
        100, 202, 202, 202, 100, 100, 100, 202, 202, 202, 202, 202, 202, 202, 202, 202, 202, 202,
        202, 100, 100, 100, 202, 202, 202, 202, 202, 202, 202, 202, 202, 202, 100, 100, 202, 202,
        202, 100, 100, 100, 202, 202, 202, 202, 202, 202, 202, 202, 202, 202, 202, 202, 100, 100,
        100, 202, 202, 202, 202, 202, 202, 202, 202, 202, 202, 100, 100, 202, 202, 202, 100, 100,
        100, 202, 202, 202, 202, 202, 202, 202, 202, 202, 202, 202, 202, 100, 100, 100, 202, 202,
        202, 202, 202, 202, 202, 202, 202, 202, 100, 100, 202, 202, 202, 100, 100, 100, 202, 202,
        202, 202, 202, 202, 202, 202, 202, 202, 202, 202, 100, 100, 100, 202, 202, 202, 202, 202,
        202, 202, 202, 202, 202, 100, 100, 202, 202, 202, 100, 100, 100, 202, 202, 202, 202, 202,
        202, 202, 202, 202, 202, 202, 202, 100, 100, 100, 202, 202, 202, 202, 202, 202, 202, 202,
        202, 202, 100, 100, 202, 202, 202, 100, 100, 100, 202, 202, 202, 202, 202, 202, 202, 202,
        202, 202, 202, 202, 100, 100, 100, 202, 202, 202, 202, 202, 202, 202, 202, 202, 202, 100,
        100, 202, 202, 202, 100, 100, 100, 100, 100, 100, 100, 100, 100, 100, 100, 100, 100, 100,
        100, 100, 100, 100, 202, 202, 202, 202, 202, 202, 202, 202, 202, 202, 100, 100, 202, 202,
        202, 100, 100, 100, 100, 100, 100, 100, 100, 100, 100, 100, 100, 100, 100, 100, 100, 100,
        100, 202, 202, 202, 202, 202, 202, 202, 202, 202, 202, 100, 100, 100, 300, 100, 100, 100,
        100, 100, 100, 100, 100, 100, 100, 100, 100, 100, 100, 100, 100, 100, 100, 100, 202, 202,
        202, 202, 202, 202, 202, 202, 202, 202, 100, 100, 202, 202, 202, 100, 100, 100, 202, 202,
        202, 202, 202, 202, 202, 202, 202, 202, 202, 202, 100, 100, 100, 202, 202, 202, 202, 202,
        202, 202, 202, 202, 202, 100, 100, 202, 202, 202, 202, 301, 202, 202, 202, 202, 901, 202,
        202, 202, 202, 202, 202, 202, 202, 202, 300, 202, 202, 202, 202, 202, 202, 202, 202, 202, 0,
        202, 100, 100, 202, 202, 202, 100, 100, 100, 202, 202, 202, 202, 202, 202, 202, 202, 202,
        202, 202, 202, 100, 100, 100, 202, 202, 202, 202, 202, 202, 202, 202, 202, 202, 100, 100,
        100, 302, 100, 100, 100, 100, 100, 100, 100, 100, 100, 100, 100, 100, 100, 100, 100, 100,
        100, 100, 100, 202, 202, 202, 202, 202, 202, 202, 202, 202, 202, 100, 100, 202, 202, 202,
        100, 100, 100, 100, 100, 100, 100, 100, 100, 100, 100, 100, 100, 100, 100, 100, 100, 100,
        202, 202, 202, 202, 202, 202, 202, 202, 202, 202, 100, 100, 202, 202, 202, 100, 100, 100,
        100, 100, 100, 100, 100, 100, 100, 100, 100, 100, 100, 100, 100, 100, 100, 202, 202, 202,
        202, 202, 202, 202, 202, 202, 202, 100, 100, 202, 202, 202, 100, 100, 100, 202, 202, 202,
        202, 202, 202, 202, 202, 202, 202, 202, 202, 100, 100, 100, 202, 202, 202, 202, 202, 202,
        202, 202, 202, 202, 100, 100, 202, 202, 202, 100, 100, 100, 202, 202, 202, 202, 202, 202,
        202, 202, 202, 202, 202, 202, 100, 100, 100, 202, 202, 202, 202, 202, 202, 202, 202, 202,
        202, 100, 100, 202, 202, 202, 100, 100, 100, 202, 202, 202, 202, 202, 202, 202, 202, 202,
        202, 202, 202, 100, 100, 100, 202, 202, 202, 202, 202, 202, 202, 202, 202, 202, 100, 100,
        202, 202, 202, 100, 100, 100, 202, 202, 202, 202, 202, 202, 202, 202, 202, 202, 202, 202,
        100, 100, 100, 202, 202, 202, 202, 202, 202, 202, 202, 202, 202, 100, 100, 202, 202, 202,
        100, 100, 100, 202, 202, 202, 202, 202, 202, 202, 202, 202, 202, 202, 202, 100, 100, 100,
        202, 202, 202, 202, 202, 202, 202, 202, 202, 202, 100, 100, 202, 202, 202, 100, 100, 100,
        202, 202, 202, 202, 202, 202, 202, 202, 202, 202, 202, 202, 100, 100, 100, 202, 202, 202,
        202, 202, 202, 202, 202, 202, 202, 100, 100, 202, 202, 202, 100, 100, 100, 202, 202, 202,
        202, 202, 202, 202, 202, 202, 202, 202, 202, 100, 100, 100, 202, 202, 202, 202, 202, 202,
        202, 202, 202, 202, 100, 100, 202, 202, 202, 100, 100, 100, 202, 202, 202, 202, 202, 202,
        202, 202, 202, 202, 202, 202, 100, 100, 100, 202, 202, 202, 202, 202, 202, 202, 202, 202,
        202, 100, 100, 202, 202, 202, 100, 100, 100, 202, 202, 202, 202, 202, 202, 202, 202, 202,
        202, 202, 202, 100, 100, 100, 202, 202, 202, 202, 202, 202, 202, 202, 202, 202, 100, 100,
        202, 1, 202, 100, 100, 100, 202, 202, 202, 202, 202, 202, 202, 202, 202, 202, 202, 202, 100,
        100, 100, 202, 202, 202, 202, 202, 202, 202, 202, 202, 202, 100, 100, 202, 202, 202, 100,
        100, 100, 202, 202, 202, 202, 202, 202, 202, 202, 202, 202, 202, 202, 100, 100, 100, 202,
        202, 202, 202, 202, 202, 202, 202, 202, 202, 100, 100, 100, 100, 100, 100, 100, 100, 100,
        100, 100, 100, 100, 100, 100, 100, 100, 100, 100, 100, 100, 100, 100, 100, 100, 100, 100,
        100, 100, 100, 100, 100, 100, 100
    ],
    "grid": [
        [
            100, 100, 100, 100, 100, 100, 100, 100, 100, 100, 100, 100, 100, 100, 100, 100, 100,
            100, 100, 100, 100, 100, 100, 100, 100, 100, 100, 100, 100, 100, 100, 100, 100
        ],
        [
            100, 202, 202, 202, 100, 100, 100, 202, 202, 202, 202, 202, 202, 202, 202, 202, 202,
            202, 202, 100, 100, 100, 202, 202, 202, 202, 202, 202, 202, 202, 202, 202, 100, 200,
            200, 200, 200, 200, 200, 200, 200, 200, 200, 200, 200, 200, 200, 200, 200, 200, 200,
            200, 200, 200, 100, 200, 200, 200, 200, 200, 200, 200, 200, 200, 200, 200, 200, 200,
            200, 200, 200, 200, 200, 200, 100, 100
        ],
        [
            100, 202, 902, 202, 100, 100, 100, 202, 202, 202, 202, 202, 202, 202, 202, 202, 202,
            202, 202, 100, 100, 100, 202, 202, 202, 202, 202, 202, 202, 202, 202, 202, 100, 200,
            200, 200, 200, 200, 200, 200, 200, 200, 200, 200, 200, 200, 200, 200, 200, 200, 200,
            200, 200, 100, 200, 200, 200, 200, 200, 200, 200, 200, 200, 200, 200, 200, 200, 200,
            200, 100, 200, 200, 200, 200, 200, 100, 100
        ],
        [
            100, 202, 202, 202, 100, 100, 100, 202, 202, 202, 202, 202, 202, 202, 202, 202, 202,
            202, 202, 100, 100, 100, 202, 202, 202, 202, 202, 202, 202, 202, 202, 202, 100, 200,
            200, 200, 200, 200, 200, 200, 200, 200, 200, 200, 200, 200, 200, 200, 200, 200, 200,
            200, 200, 100, 100, 100, 200, 100, 200, 100, 200, 200, 100, 200, 100, 200, 200, 100
        ],
        [
            100, 202, 202, 202, 100, 100, 100, 202, 202, 202, 202, 202, 202, 202, 202, 202, 202,
            202, 202, 100, 100, 100, 202, 202, 202, 202, 202, 202, 202, 202, 202, 202, 100
        ],
        [
            100, 202, 202, 202, 100, 100, 100, 202, 202, 202, 202, 202, 202, 202, 202, 202, 202,
            202, 202, 100, 100, 100, 202, 202, 202, 202, 202, 202, 202, 202, 202, 202, 100
        ],
        [
            100, 202, 202, 202, 100, 100, 100, 202, 202, 202, 202, 202, 202, 202, 202, 202, 202,
            202, 202, 100, 100, 100, 202, 202, 202, 202, 202, 202, 202, 202, 202, 202, 100
        ],
        [
            100, 202, 202, 202, 100, 100, 100, 202, 202, 202, 202, 202, 202, 202, 202, 202, 202,
            202, 202, 100, 100, 100, 202, 202, 202, 202, 202, 202, 202, 202, 202, 202, 100
        ],
        [
            100, 202, 202, 202, 100, 100, 100, 202, 202, 202, 202, 202, 202, 202, 202, 202, 202,
            202, 202, 100, 100, 100, 202, 202, 202, 202, 202, 202, 202, 202, 202, 202, 100
        ],
        [
            100, 202, 202, 202, 100, 100, 100, 202, 202, 202, 202, 202, 202, 202, 202, 202, 202,
            202, 202, 100, 100, 100, 202, 202, 202, 202, 202, 202, 202, 202, 202, 202, 100
        ],
        [
            100, 202, 202, 202, 100, 100, 100, 202, 202, 202, 202, 202, 202, 202, 202, 202, 202,
            202, 202, 100, 100, 100, 202, 202, 202, 202, 202, 202, 202, 202, 202, 202, 100
        ],
        [
            100, 202, 202, 202, 100, 100, 100, 202, 202, 202, 202, 202, 202, 202, 202, 202, 202,
            202, 202, 100, 100, 100, 202, 202, 202, 202, 202, 202, 202, 202, 202, 202, 100
        ],
        [
            100, 202, 202, 202, 100, 100, 100, 100, 100, 100, 100, 100, 100, 100, 100, 100, 100,
            100, 100, 100, 100, 100, 202, 202, 202, 202, 202, 202, 202, 202, 202, 202, 100
        ],
        [
            100, 202, 202, 202, 100, 100, 100, 100, 100, 100, 100, 100, 100, 100, 100, 100, 100,
            100, 100, 100, 100, 100, 202, 202, 202, 202, 202, 202, 202, 202, 202, 202, 100
        ],
        [
            100, 100, 300, 100, 100, 100, 100, 100, 100, 100, 100, 100, 100, 100, 100, 100, 100,
            100, 100, 100, 100, 100, 202, 202, 202, 202, 202, 202, 202, 202, 202, 202, 100
        ],
        [
            100, 202, 202, 202, 100, 100, 100, 202, 202, 202, 202, 202, 202, 202, 202, 202, 202,
            202, 202, 100, 100, 100, 202, 202, 202, 202, 202, 202, 202, 202, 202, 202, 100
        ],
        [
            100, 202, 202, 202, 202, 301, 202, 202, 202, 202, 901, 202, 202, 202, 202, 202, 202,
            202, 202, 202, 300, 202, 202, 202, 202, 202, 202, 202, 202, 202, 0, 202, 100
        ],
        [
            100, 202, 202, 202, 100, 100, 100, 202, 202, 202, 202, 202, 202, 202, 202, 202, 202,
            202, 202, 100, 100, 100, 202, 202, 202, 202, 202, 202, 202, 202, 202, 202, 100
        ],
        [
            100, 100, 302, 100, 100, 100, 100, 100, 100, 100, 100, 100, 100, 100, 100, 100, 100,
            100, 100, 100, 100, 100, 202, 202, 202, 202, 202, 202, 202, 202, 202, 202, 100
        ],
        [
            100, 202, 202, 202, 100, 100, 100, 100, 100, 100, 100, 100, 100, 100, 100, 100, 100,
            100, 100, 100, 100, 100, 202, 202, 202, 202, 202, 202, 202, 202, 202, 202, 100
        ],
        [
            100, 202, 202, 202, 100, 100, 100, 100, 100, 100, 100, 100, 100, 100, 100, 100, 100,
            100, 100, 100, 100, 100, 202, 202, 202, 202, 202, 202, 202, 202, 202, 202, 100
        ],
        [
            100, 202, 202, 202, 100, 100, 100, 202, 202, 202, 202, 202, 202, 202, 202, 202, 202,
            202, 202, 100, 100, 100, 202, 202, 202, 202, 202, 202, 202, 202, 202, 202, 100
        ],
        [
            100, 202, 202, 202, 100, 100, 100, 202, 202, 202, 202, 202, 202, 202, 202, 202, 202,
            202, 202, 100, 100, 100, 202, 202, 202, 202, 202, 202, 202, 202, 202, 202, 100
        ],
        [
            100, 202, 202, 202, 100, 100, 100, 202, 202, 202, 202, 202, 202, 202, 202, 202, 202,
            202, 202, 100, 100, 100, 202, 202, 202, 202, 202, 202, 202, 202, 202, 202, 100
        ],
        [
            100, 202, 202, 202, 100, 100, 100, 202, 202, 202, 202, 202, 202, 202, 202, 202, 202,
            202, 202, 100, 100, 100, 202, 202, 202, 202, 202, 202, 202, 202, 202, 202, 100
        ],
        [
            100, 202, 202, 202, 100, 100, 100, 202, 202, 202, 202, 202, 202, 202, 202, 202, 202,
            202, 202, 100, 100, 100, 202, 202, 202, 202, 202, 202, 202, 202, 202, 202, 100
        ],
        [
            100, 202, 202, 202, 100, 100, 100, 202, 202, 202, 202, 202, 202, 202, 202, 202, 202,
            202, 202, 100, 100, 100, 202, 202, 202, 202, 202, 202, 202, 202, 202, 202, 100
        ],
        [
            100, 202, 202, 202, 100, 100, 100, 202, 202, 202, 202, 202, 202, 202, 202, 202, 202,
            202, 202, 100, 100, 100, 202, 202, 202, 202, 202, 202, 202, 202, 202, 202, 100
        ],
        [
            100, 202, 202, 202, 100, 100, 100, 202, 202, 202, 202, 202, 202, 202, 202, 202, 202,
            202, 202, 100, 100, 100, 202, 202, 202, 202, 202, 202, 202, 202, 202, 202, 100
        ],
        [
            100, 202, 202, 202, 100, 100, 100, 202, 202, 202, 202, 202, 202, 202, 202, 202, 202,
            202, 202, 100, 100, 100, 202, 202, 202, 202, 202, 202, 202, 202, 202, 202, 100
        ],
        [
            100, 202, 1, 202, 100, 100, 100, 202, 202, 202, 202, 202, 202, 202, 202, 202, 202, 202,
            202, 100, 100, 100, 202, 202, 202, 202, 202, 202, 202, 202, 202, 202, 100
        ],
        [
            100, 202, 202, 202, 100, 100, 100, 202, 202, 202, 202, 202, 202, 202, 202, 202, 202,
            202, 202, 100, 100, 100, 202, 202, 202, 202, 202, 202, 202, 202, 202, 202, 100
        ],
        [
            100, 100, 100, 100, 100, 100, 100, 100, 100, 100, 100, 100, 100, 100, 100, 100, 100,
            100, 100, 100, 100, 100, 100, 100, 100, 100, 100, 100, 100, 100, 100, 100, 100
        ]
    ]
}